1111111111
1000000001
1010000101
1<11001101
1001111001
1001111001
1011001101
1010000101
1000000001
1111111111
