1111111111111
1>00000000001
1111000001111
1000000000001
1111000001111
1000000000001
1111000001111
1000000000001
1111000001111
1000000000001
1111000001111
1000000000001
1111000001111
1000000000001
1111000001111
1000000000001
1111000001111
1000000000001
1111000001111
1000000000001
1111000001111
1000000000001
1111000001111
1000000000001
1111000001111
1000000000001
1111000001111
1000000000001
1111000001111
1000000000001
1111000001111
1000000000001
1111000001111
1000000000001
1111000001111
1000000000001
1111000001111
1000000000001
1111000001111
1000000000001
1111000001111
1000000000001
1111000001111
1000000000001
1111111111111
