1111111111
1000000001
1020000201
1033A03301
1002222001
1002222001
1033003301
1020000201
1000000001
1111111111
