444444444444444444444444444444444444444444444444444
4000000000000000000000000V0000000000000000000000004
400003330000000003330000000000033300000000033300004
400003330000000003330000000000033300000000033300004
400003330000000003330000000000033300000000033300004
403333333330003333333330000033333333300033333333304
403333333330003333333330000033333333300033333333304
403333333330003333333330000033333333300033333333304
400003330000000003330000000000033300000000033300004
400003330000000003330000000000033300000000033300004
400003330000000003330000000000033300000000033300004
400000000000000000000000080000000000000000000000004
400700000700000700000700000007000007000007000007004
400110001100000110001100000001100011000001100011004
400033333000000033333000000000333330000000333330004
400033333000000033333000000000333330000000333330004
400110001100000110001100000001100011000001100011004
400600000600000600000600000006000006000006000006004
400000000000000000000000080000000000000000000000004
434444044443003444044430000034440444300344440444434
430000000003003000000030000030000000300300000000034
434444044443003444044430000034440444300344440444434
430000000003003000000030000030000000300300000000034
434444044443003444044430000034440444300344440444434
430000000003003000000030000030000000300300000000034
434444044443003444044430000034440444300344440444434
430000000003003000000030000030000000300300000000034
434444044443003444044430000034440444300344440444434
430000000003003000000030000030000000300300000000034
434444044443003444044430000034440444300344440444434
430000000003003000000030000030000000300300000000034
434444044443003444044430000034440444300344440444434
430000000003003000000030000030000000300300000000034
434444044443003444044430000034440444300344440444434
430000000003003000000030000030000000300300000000034
434444044443003444044430000034440444300344440444434
430000000003003000000030000030000000300300000000034
434444044443003444044430000034440444300344440444434
434444044443003444044430000034440444300344440444434
430000000003003000000030000030000000300300000000034
434444044443003444044430000034440444300344440444434
430000000003003000000030000030000000300300000000034
434444044443003444044430000034440444300344440444434
430000000003003000000030000030000000300300000000034
434444044443003444044430000034440444300344440444434
430000000003003000000030000030000000300300000000034
434444044443003444044430000034440444300344440444434
430000000003003000000030000030000000300300000000034
434444044443003444044430000034440444300344440444434
430000000003003000000030000030000000300300000000034
434444044443003444044430000034440444300344440444434
430000000003003000000030000030000000300300000000034
434444044443003444044430000034440444300344440444434
430000000003003000000030000030000000300300000000034
434444044443003444044430000034440444300344440444434
430000000003003000000030000030000000300300000000034
434444044443003444044430000034440444300344440444434
400000000000000000000000080000000000000000000000004
400500000500000500000500000005000005000005000005004
400110001100000110001100000001100011000001100011004
400033333000000033333000000000333330000000333330004
400033333000000033333000000000333330000000333330004
400110001100000110001100000001100011000001100011004
400200000200000200000200000002000002000002000002004
400000000000000000000000080000000000000000000000004
400003330000000003330000000000033300000000033300004
400003330000000003330000000000033300000000033300004
400003330000000003330000000000033300000000033300004
403333333330003333333330000033333333300033333333304
403333333330003333333330000033333333300033333333304
403333333330003333333330000033333333300033333333304
400003330000000003330000000000033300000000033300004
400003330000000003330000000000033300000000033300004
400003330000000003330000000000033300000000033300004
400000000000000000000000080000000000000000000000004
444444444444444444444444444444444444444444444444444