1111111111
1000000001
1020000201
1044A04401
1002222001
1002222001
1044004401
1020000201
1000000001
1111111111
