1111111111111
200000V000002
1111110111111
2000000000002
1111110111111
2000000000002
1111110111111
2000000000002
1111110111111
2000000000002
1111110111111
2000000000002
1111110111111
2000000000002
1111110111111
2000000000002
1111110111111
2000000000002
1111110111111
2000000000002
1111110111111
2000000000002
1111110111111
2000000000002
1111110111111
2000000000002
1111110111111
2000000000002
1111110111111
2000000000002
1111110111111
2000000000002
1111110111111
2000000000002
1111110111111
2000000000002
1111110111111
2000000000002
1111111111111
